25 50
24 0
20 4
0 49
OOOOOOOOOOOOOOOOOOOOOOOOOOOOOOOOOOOOXOOOOOOOOOOOOO
OOOOOOOOOOOOOOOOOOOOOOOOOOOOOOOOOOOOXOOOOOOOOOOOOO
OOOOOOOOOOOOOOOOOOOOOOOOXOOOOOOOOOOOXOOOOOOOOOOOOO
OOOOOOOOOOOOOOOOOOOOOOOOXOOOOOOOOOOOXOOOOOOOOOOOOO
OOOOOOOOOOOOOOOOOOOOOOOOXOOOOOOOOOOOXOOOOOOOOOOOOO
OOOOOOOOOOOOOOOOOOOOOOOOXOOOOOOOOOOOXOOOOOOOOOOOOO
OOXXXXXXXXXXXOOOOOOOOOOOXOOOOOOOOOOOXOOOOOOOOOOOOO
OOOOOOOOOOOOXOOOOOOOOOOOXOOOOOOOOOOOXOOOOOOOOOOOOO
OOOOOOOOOOOOXOOOOOOOOOOOXOOOOOOOOOOOXOOOOOOOOOOOOO
OOOOOOOOOOOOXOOOOOOOOOOOXOOOOOOOOOOOXOOOOOOOOOOOOO
OOOOOOOOOOOOXOOOOOOOOOOOXOOOOOOOOOOOXOOOOOOOOOOOOO
OOOOOOOOOOOOXOOOOOOOOOOOXOOOOOOOOOOOXOOOOOOOOOOOOO
OOOOOOOOOOOOXOOOOOOOOOOOXOOOOOOOOOOOXOOOOOOOOOOOOO
OOOOOOOOOOOOXOOOOOOOOOOOXOOOOOOOOOOOXOOOOOOOOOOOOO
OOOOOOOOOOOOXOOOOOOOOOOOXOOOOOOOOOOOXOOOOOOOOOOOOO
OOOOOOOOOOOOXOOOOOOOOOOOXOOOOOOOOOOOXOOOOOOOOOOOOO
OOOOOOOOOOOOXOOOOOOOOOOOXOOOOOOOOOOOXOOOOOOOOOOOOO
OOOOOOOOOOOOXOOOOOOOOOOOXOOOOOOOOOOOXOOOOOOOOOOOOO
OOOOOOOOOOOOXOOOOOOOOOOOXOOOOOOOOOOOXOOOOOOOOOOOOO
OOOOOOOOOOOOOOOOOOOOOOOOXOOOOOOOOOOOOOOOOOOOOOOOOO
OOOOOOOOOOOOOOOOOOOOOOOOXOOOOOOOOOOOOOOOOOOOOOOOOO
OOOOOOOOOOOOOOOOOOOOOOOOXOOOOOOOOOOOOOOOOOOOOOOOOO
OOOOOOOOOOOOOOOOOOOOOOOOXOOOOOOOOOOOOOOOOOOOOOOOOO
OOOOOOOOOOOOOOOOOOOOOOOOXOOOOOOOOOOOOOOOOOOOOOOOOO
OOOOOOOOOOOOOOOOOOOOOOOOXOOOOOOOOOOOOOOOOOOOOOOOOO
