25 105
17 0
2 1
21 0
XOOOXOOOXOOOOOXOOOXXOOXOOOOOXOOXOOOOOOOOXXOXOXXOOOOOOOOOOOOOOOOOOOOOOOOOOOOOOOOOOOOOOOOOOOOOOOOOOOOOOOOOO
XXOOOXOOOXOOOOOXOOXXOXOOOOOXOXOOXXOXOOOOXXOOOXXOXOOOOOOOOOXXXXXXXXXXXXXXXXXXXXXXXXXOOOOOOOOOOOOOOOOOOOOOO
XOXOOOXOOOOOXOOXOOXXXOOOOOXOXOOOOOOOXOOOXXOXOXXOXOOOOOOOOOOXOOXXXXXXXXXXXXXXXXOOOOOOOOOOOXXXXXXXXXXXXXOOO
XOOXOOOXOOOXOXOOOOOOOOOOOOOOOOOOOXOOOOOOOOOOOOOOOOOOOOOOOOOOOOOOOOOOOOOOOOOOOOOOOOOOOOOOOXXXXXXXXXXXXXXXX
OOOOXOOOXOXOOXOXOOOXOOOOOOOOOOOOOOXOOXOOXXOXOXXOXOOOOOOOOXXOOOOOOOOOOOOXXOOOOOOOOOOOOOOOOOOXOOOOOOOOOOOOO
OOOOOOOXXXOOOOOXOOOXOOOXOOOOOOOOOOOOOOOOXXOXOXXOXOOOOOOOOOOOOOOOOOOOOOOXXOOOOOOOOOOOOOOOOOOXOOOOOOOOOOOOO
OOOXXOOOOOOOOOOOOOOOOOOOOOOOOOOOOOOXOOOOXXOXOXXOXOOOOOOOOOOOOOOOOOOOOOOOXXXXXXXXXXXXXXXXXXXXXXXXXXXXXXXXX
OXOOOOOXXXOOOOOOOOOXOXOOOXOOOOXOOOXOOOOOXXOXOXXOXOOOOOOOOOOOOOOOOOOOOOOOXXXOOOOOOOOOOOOOXXOOOOXXOOOOOOOOO
OOXOOOXOXXOOOOOOOOOXOOXOOOOOOXOOOOOXOOOOOOOOOOOXOOOOOOOOOXOOXXXXXXOOOOOOOOOOOOOOOXXXXOOOOOOOOOOOXXXXXXXXX
XOOOOOXOOOOOOOOOOOOXOOOXOOOOXOOOOOOOOOOOXOOXOXXOXOOOOOOOOOOOOOOOOOOOOOOOOOOOOOOOOOOOOOOOOOOOOOOOOOOOOOOOO
XOOOXOOOOOOOXOOOOOXXOXOOXXXXXOOOXOOOXOOOXXOXOXXOXXXXXXXXXXXXXXXXXXXXOOOOOOOXXXXXXXXXXXXXXXXXXXXXXXXXXXXXO
XOOOOOXOOXOOOOOOOOXXOOXOOOOOOOOOOXOOOXOOXXOXOOOOXXXXXXXXXXXXXXXXXXXXXXOOOOOOOOOXXXXXOOOOOOOOOOOOOOOOOOOOO
XOOOOOOOOOOOOOOOOOXXOOOOOOOOOOOOOOXOOOOOXXOXOXXOXXXXXXXXXXXXXXXXXXXXXXXXXXXXOOOOOOOOOOOXXXXXXXXXXOXXXXXXX
XOOOXOOOXOOOOOXOOOXXOOXOOOOOXOOOOOOOOOOOOOOXOXXOXOOOOOOXXOOOOOOOOOXOXOOOOOOOOOOOOOOXOOOOOOOXOOOOOOOOOOOOO
XXOOOXOOOXOOOOOXOOXXOXOOOOOXXOXOXOOXOOXOXOOXOXXOXXXOOOOOXXXXOOOOOOOOOXOOOOOOOOOOOOOOOOOOOOXOXOOOOOOOOOOOO
XOXOOOXOOOOOXOOXOOXXXOOOOOXOOOOOOXOOOOOOXXOXOXXOXOOOOOXXXXXXOOOOOOOXOOOOOOOOOOOOOOOOXOOOOXOOOXOOOOOOOOOOO
XOOXOOOXOOOXOXOOOOOXOOOOOOOOOOOXOOOOOOOOXXOXOXXOXXXOOOXXXXXOXOOOOOOXOOXXOOOOOOOOOOXOXOOOXOOOOOXOOOOOOOOOO
OOOOXOOOXOXOOXOXOOOXOOXOXXOOXXXOOOOXOOOOOOOXOXXOXXXOOOOOOOOOOXOOOOXXXOOOOOOOOOOOXXOOOOOXOOOOOOXOOOOOOOOOO
OOOOOOOOOOOOOOOOOOOOOOOOOOOOOOOOOOOOXOOOOOOXOXXOXXOOOOOOOOOOOXOOOOXXOOOOOOOOOOOOOOOXOOXOOOOOOXOXXOOOOOOOO
XXXXXXXXXXXXXXXXXXXXXXXXXXXXXXXXXXXXXXXXXXXXXXXXXXOOOOOOOOOOOOXOOOXXOOOOOOOOOOOOOOOOOXOOOOOOOOOXOOOOOOOOO
XOOOOOOOOOOOOOOOOOOOOOOOOOOOOOOOOOOOOOOOOOOOOOOOOOOOOOOOOOOOOOOOOOOOOOOOOOOOXXXXXXXXOOOOOOOOOOOXOOOOOOOOO
OXOOOOOOOOOOOOOOOOOOOOOOOOOOOOOOOOOOOOOOOOOOOOOOOOOOOOOOOOOOOXXOXXOXOOOOOOOOOOOOOXXXOOOOOOOOOXOOOOOOOOOOO
OOXOOOOOOOOOOOOOOOOOOOOOOOOOOOOOOOOOXXXXOOOOOOOOOOOOOOOOOOOOOOOOOOOXOOOOOOOOOXOOOOXXXOOOOOOOOOXOOOOOOOOOO
OOOXOOOOOOOOOOOOOOOOOOOOOOOXXXXXXXXXOOOOOOOOOOOOOOOOOOOOOOOOOXOOOOOXOOOOOOOOOXOOOOOXXXOOOOOOOOOOOOXOOOOOO
OOOOOOOOOOOOOOXXXXXXXXXXXXXOOOOOOOOOOOOOOOOOOOOOOOOOOOOOOOOOOOXOOOOOOOXXXXXXXXOOOOOOXXXOOOOOOOOOOOOXOOOOO
